xxxxxxxBxxx
x.....xxx.x
x...xxxx..x
x...xxxx..x
x....A....x
x..xx.xx..x
x.........x
x.........x
xxxxxxxxxxx